After "Aftır" - Sonra
Agreed "Egriid" - Anlaşıldı, Kararlaştırıldı	
Answer "Ensvır" - Cevap	
Art "Art" - Sanat	
Abandon "Ebendın" - Terk Etmek, Bırakmak	
Ability "Ebiliti" - Hüner, Beceri, Kabiliyet	
About	"Ebaut" - Hakkında, Aşağı Yukarı, Üzere	
Above	"Ebov" - Üstünde, Üzerine	
Abroad	"Ebrood" - Yurt Dışında, Yurtdışı
Absence	"Ebsıns" - Bulunmama, Yokluk	
Absolute "Ebsulut" - Mutlak, Salt, Kesin	
Absolutely	"Ebsulutli" - Mutlaka, Kesinlikle	
Abuse	"Ebus" - Suistimal Etmek, Kötüye Kullanmak
Accept	"Eksept" - Kabul Etmek	
Access	"Ekses" - Giriş, Erişim, Erişmek	
Accompany	"Ekompani" - Eşlik Etmek	
Accomplish	"Ekkompliş" - Başarıyla Tamamlamak, Sonuçlandırmak
Accurate	"Ekkurıt" - Kesin, Doğru
Accuse	"Ekkuus" - Suçlamak, İtham Etmek	
Achieve	"Eçiv" - Elde Etmek, Başarmak	
Acknowledge	"Eknovlıç" - Kabul Etmek, Kabullenmek
Acquire	"Ekkuayır" - Edinmek, Elde Etmek
Across	Karşıya, -Karşı karşıya	Ekross
Act	Davranmak, -Hareket Etmek, Eylem	Ekt
Action	Aksiyon, -Eylem	Ekşın
Active	Etkin, -Aktif	Ektiv
Activity	Faaliyet, -Etkinlik, Aktivite	Ektiviti
Adapt	Uymak, -Uyarlamak, Adapte Olmak	Adapt
Add	Eklemek, -İlave Etmek	Edd
Addition	İlave, -Ek	Addişın
Adequate	Yeterli, -Münasip	Edekueyt
Adjustment	Ayarlama, -Ayar	Edjastmınt
Administration	İdare, -Yönetim	Edministirayşın
Administrator	İdareci, -Yönetici	Edministreytır
Admire	Hayran -Olmak, Beğenmek	Edmayır
Admission	Kabul, -İtiraf	Edmişşın
Admit	Kabul -Etmek, İtiraf Etmek	Edmit
Adopt	Evlat -Edinmek, Benimsemek	Adopt
Advance	İlerlemek, -Avans, Geliştirmek	Edvens
Advanced	İleri, -Gelişkin	Edvensd
Advantage	Avantaj, -Fayda	Edventıç
Adventure	Macera, -Serüven	Edvençur
Advertising	Reklamcılık, -Reklam	Edvırtaysing
Advice	Tavsiye, -Nasihat	Edvays
Advise -(v)	Nasihat Etmek, Öğütlemek	Edvays
Adviser	Müşavir, -Danışman	Edvaysır
Advocate -(v)	Müdafaa Etmek, Savunmak	Edvokıt
Afford	Parası -Yetmek	Efford
Afraid	Korkmuş, -Ürkmüş	Efreyd
Afternoon	Öğleden -Sonra	Aftırnuun
Again	Tekrar, -Yeniden	Egeyn
Against	Karşı, -Aykırı	Egeynst
Age	Yaş, -Çağ	Eyc
Agency	Ajans, -Acente	Eycınsi
Agenda	Gündem, -Ajanda	Ajenda
Agent	Ajan, -Temsilci	Eycınt
Aggressive	Kavgacı, -Agresif	Agressiv
Ago	Evvel, -Önce	Ego
Agree	Aynı -Fikirde Olmak, Anlaşmak, Katılmak	Egrii
Agreement	Anlaşma, -Mutabakat	Egriimınt
Agriculture	Tarım, -Ziraat	Agrikulçır
Ahead	İleride, -İleri	Eheed
Aid	Yardım -Etmek, Yardım	Eyd
Aim	Amaçlamak, -Amaç, Hedef	Eym
Aircraft	Uçak, -Hava Taşıtı	Eyırkıraft
All	Tüm, -Hepsi	All
Alliance	Antlaşma, -İttifak	Ellayıns
Allow	İzin -Vermek	Ellov
Almost	Hemen -Hemen, Neredeyse	Olmost
Already	Zaten, -Halihazırda	Alredi
Always	Her -Zaman, Daima	Alveys
Among	Arasında, -Arasına	Emong
Amount	Meblağ, -Tutar	Emount
Analysis	Analiz, -Tahlil	Enalaysis
Analyze	Analiz -Etmek, Incelemek	Enalayz
Anger	Öfke, -Hiddet	Engır
Angry	Kızgın, -Sinirli	Engri
Announce	Duyurmak, -Anons Etmek	Ennouns
Annual	Senelik, -Yıllık	Enual
Another	Öbür, -Başka	Enadır
Anticipate	Beklemek, -Ummak	Antisipeyt
Anxiety	Endişe, -Kaygı	Engzayıti
Anybody	Kimse, -Hiç Kimse	Enibadi
Anyone	Hiç -Kimse, Kimse	Enivan
Anyway	Neyse, -Her Neyse	Enivey
Anywhere	Her -Yer, Herhangi Bir Yer	Eniveer
Apparent	Görünür, -Aşikar	Epiyırınt
Apparently	Belli -ki, Anlaşılan, Görünüşte	Epiyırıntli
Appeal	Başvurmak, -Temyiz, Cazibe	Eppiyıl
Appear	Belli -Olmak, Görünmek	Eppiyır
Application	Başvuru, -Uygulama	Epplikeyşın
Apply	Başvurmak, -Uygulamak	Epplay
Appointment	Randevu, -Atama, Tayin	Epoyntmınt
Appreciate	Değerini -Artırmak, Beğenmek	Epprışıeyt
Approach	Yanaşmak, -Yaklaşım	Eprooç
Appropriate	Münasip, -Uygun	Eproprieyt
Approval	Tasvip, -Onay	Epruvıl
Approve	Kabul -Etmek, Beğenmek, Onaylamak	Epruuv
Approximately	Takriben, -Aşağı Yukarı	Eproksimıtli
Area	Alan, -Bölge	Eriya
Argument	Argüman, -Sav	Argümınt
Armed	Ateşli, -Silahlı	Armd
Around	Sularında, -Etrafında, Çevresinde	Eround
Arrange	Ayarlamak, -Düzenlemek	Erreyinç
Arrangement	Düzenleme, -Ayarlama	Erreyinçmınt
Arrival	Gelmek, -Geliş, Varış	Errayvıl
Arrive	Varmak, -Ulaşmak	Errayv
Aside	Bertaraf, -Ayrı	Esayd
Ask	Sormak, -İstemek	Esk
Asleep	Uyuyan, -Uyuşuk	Asliip
Aspect	Hal, -Görünüş, Yön	Aspekt
Assault	Saldırmak, -Saldırı	Essalt
Assert	İleri -Sürmek, İddia Etmek	Assört
Assess	Değer -Biçmek	Essess
Assign	Atamak, -Tahsis Etmek	Essayn
Assignment	Atama, -Görevlendirme	Essaynmınt
Assist	Yardım -Etmek	Assist
Assistant	Yardımcı, -Asistan	Assistınt
Associate	Birleştirmek, -İlişkilendirmek	Assoşieyt
Association	Birlik, -Dernek	Assoşieyşın
Assume	Farzetmek, -Varsaymak	Essum
Assumption	Farzetme, -Varsayım	Essumpşın
Assure	Garanti -Etmek	Aşşur
Attach	Eklemek, -İliştirmek	Etteç
Attack	Saldırmak, -Saldırı	Ettek
Attempt	Girişimde -Bulunmak	Etempt
Attention	İlgi, -Özen, Dikkat	Etenşın
Attitude	Tavır, -Tutum	Etdituud
Attractive	Çekici, -Cazibeli	Etrektiv
Attribute	Bağlamak, -Atfetmek, Dayandırmak	Etribüt
Audience	Kitle, -İzleyici, Seyirci	Odiıns
Authority	Otorite, -Yetki	Otoriti
Available	Müsait, -Mevcut, Uygun	eveylıbıl
Avoid	Kaçınmak, -Önlemek	Evoyd
Aware	Farkında, -Haberdar	Eveer
Awareness	Farkındalık, -Farkında Olma	Eveernıss
Away	Uzak, -Uzakta	Evey
Backpack	Sırt -Çantası	Bekpek
Badly	Kötü -Bir Şekilde	Bedli
Band	Müzik -Grubu	Bend
Barely	Zar -Zor	Berli
Basic	Esas, -Temel	Beyzik
Basically	Temelde, -Esasen, Aslında	Beyzikıli
Beach	Plaj, -Sahil, Kumsal	Biiç
Become	Olmak, -Haline Gelmek	Bikam
Bedroom	Yatak -Odası	Bedrum
Behavior	Davranış, -Tavır, Hal	Biheyviyır
Behind	Arkada, -Arkasında	Bihaynd
Belong	Ait -Olmak	Bilon
Best	En -İyi	Best
Bet	İddaa, -İddiaya Girmek	Bet
Better	Daha -İyi	Bettır
Bill	Fatura, -Senet	Bill
Birthday	Doğum -Günü	Börtdey
Bite	Isırmak, -Lokma	Bayt
Blame	Ayıplamak, -Suçlamak	Bleym
Border	Sınır, -Hudut, Kenar	Bordır
Borrow	Ödünç -Almak	Borrov
Bowl	Kase, -Tas	Bovl
Boyfriend	Erkek -Arkadaş, Sevgili	Boyfrend
Breathe	Nefes -Almak	Briiid
Broken	Bozuk, -Kırık	Brokın
Brother	Erkek -Kardeş	Bradır
Brush	Fırça, -Fırçalamak	Braş
Build	İnşa -Etmek	Biylt
Burn	Yakmak, -Yanmak	Börn
Button	Düğme, -Buton	Battın
Buy	Satın -Almak	Bay
Call -off	İptal etmek	Kal of
Captor	Esir -alan	Keptor
Census	Nüfus -Sayımı	Sensıs
Charm	Alımlı, -Sevimli	Çarm
Clay	Kil, -çamur	Kley
Clerk	Yazıcı, -katip	Klörk
Cling	Yapışmak, -Sarılmak	Kling
Commitment	Vaat, -Taahhüt, Bağlılık	Kommitmınt
Compatible	Uygun, -Münasip	Kompetibıl
Conflict	Çatışma, -Kavga, Zıtlık	Konflikt
Cool	Serin, -Havalı	Kuul
Count -(v)	Saymak	Kaunt
Dawn	Şafak, -Tan	Davn
Dear	Sevgili, -Değerli	Diyır
Decay	Çürümek, -Bozulmak	Dikey
Decline	Reddetmek, -Geri Çevirmek	Diklayn
Defect	Defo, -Özür	Difect
Delightful	Hoş, -Güzel	Dilaytful
Demolition	Yıkma, -Tahrip	Demolişın
Dent	Çöküntü, -Göçük	Dent
Dependable	Güvenilir, -Emin	Dipendıbıl
Deprive	Yoksun -Bırakmak	Diprayv
Dinner	Akşam -Yemeği	Dinnır
Disgrace	Utanç, -Ayıp	Disgreys
Dizziness	Baş -Dönmesi	Dizinıs
Doctor	Doktor, -Hekim	Daktır
Enormous	Muazzam, -Kocaman	İnormıs
Earth	Toprak, -Dünya	Örth
Earn	Para -Kazanmak	Örn
Expect	Ümit -etmek	Ekspekt
Exit	Çıkış, -Çıkmak	Egzıt
Eastern	Doğuya -ait, Doğu	İstörn
Equal	Eşit, -Denk	İkuul
Essay	Rapor, -Makale	Essey
Feasible	Mümkün, -Yapılabilir	Fisibıl
Fade	Rengi -Solmak, Silinmek	Feyd
Fulfill	Tatmin -etmek	Fulfil
Fence	Çit, -Parmaklık	Fens
Fierce	Şiddetli, -Hiddetli	Fiyırs
Flimsy	Dayanıksız, -Çürük	Flimsi
Flee	Kaçmak, -Kaçırmak	Flii
Flavor	Tat, -Lezzet	Fleyvır
Fortunate	Minnettar, -Müteşekkir	Forçunıt
Gap	Boşluk, -Fark	Gep
Genius	Deha, -Dahi	Jiniyıs
Genuine	Hakiki, -Gerçek	Cenuin
Get	Elde -Etmek, Almak	Get
Guest	Misafir, -Konuk	Gest
Grocery -Store	Market	Groseri Stor
Gravity	Yer -çekimi	Greviti
Grass	Çimen, -Ot	Gras
Glory	Görkem, -Şan	Glori
Globe	Küre, -Dünya	Glob
Gift	Armağan, -Yetenek	Gift
High	Yüksek, -Zirve	Hay
Headache	Baş -ağrısı	Hedeyk
Heat	Isı, -Sıcaklık	Hiit
Help	Yardım -Etmek	Help
Herb	Bitki, -Ot	Örb
Have	Sahip -Olmak	Hev
Image	Görüntü, -İmge	İmıç
Insane	Deli, -Kaçık	İnseyn
Invade	İstila -Etmek	İnveyd
Invent	İcat -Etmek	İnvent
Inhale	Nefes -Almak, İçine Çekmek	İnheyl
Impulse	Dürtü, -Güdü	İmpuls
Invade	İstila -etmek	İnveyd
Invasion	Akın, -Saldırı, İstila	İnveyşın
Ironic	Alaylı, -Alaycı	Ayronik
Jet -engine	Jet Motoru	Jet Encin
Jukebox	Müzik -Kutusu	Jukbaks
Junk	Ivır -Zıvır	Jank
Keep	Korumak, -Tutmak, Devam Etmek	Kiip
Kick	Tekme, -Tekmelemek	Kik
Kid	Çocuk, -Ufaklık, Dalga Geçmek	Kid
Kind	İyi, -Nazik, Çeşit	Kaynd
Kiss	Öpücük, -Öpmek	Kiss
Knee	Di̇z, -Di̇z Çökmek	Nii
Knock	Vurmak -(Kapıya Vurmak)	Nak
Knot	Düğüm, -Düğüm Atmak	Not
Kidnap	Zorla -Kaçırmak (İnsan, Hayvan Vb.)	Kidnep
Kin	Ai̇le, -Akraba	Kin
Knight	Si̇lahşör, -Şovalye, Satrançta At	Nayt
Knob	Tokmak, -Tutacak	Nob
Labor	İş -(Elle Yapılan Zor İş), İş Gücü	Leybır
Lamb	Kuzu, -Kuzu, Koyun Eti̇	Lemb
Lame	Topal, -Sıkıcı	Leym
Land	Kara, -Arazi	Lend
Land -(v)	İni̇ş Yapmak, Konmak (Uçak vs..)	Lend
Language	Di̇l -( Yabancı Dil vs.)	Lenguıç
Last	Son, -Sonunda, Geçmi̇ş	Last
Last	Devam -Etmek, Sürmek, Yeterli̇ Olmak	Last
Late	Geç, -Sonu (Late September: Eylül Sonu vs.)	Leyt
Laundry	Yıkanacak -Çamaşır, Çamaşırhane	Landri
Law	Yasa, -Kanun, Hukuk	Lov
Lead	Önderli̇k -Etmek, Önde Gi̇tmek, Yol Göstermek	Liid
Leader	Önder, -Li̇der	Lidır
Least	En -Az	Liist
Leave	Terk -Etmek	Liiv
Lend	Ödünç -Vermek	Lend
Less	Daha -Az	Less
Letter	Mektup, -Harf	Lettır
Letter -Box	Mektup Kutusu,Posta Kutusu	Letır Baks
Level	Düzey, -Sevi̇ye	Levıl
Liberty	Serbest -Olmak	Libırti
Library	Ki̇taplık, -Kütüphane	Laybreri
License	Li̇sans -(Ehliyet vs. )	Laysıns
Lie	Yalan, -Yalan Söylemek	Lay
Life	Yaşam, -Hayat	Layf
Lift	Asansör, -Yukarı Kaldırmak	Lift
Light	Işık, -Açık (Renklerde), .Hafi̇f	Layt
Like	Hoşlanmak, -Gi̇bi̇	Layk
Likely	Büyük -Olasılıkla	Laykli
Line	Çi̇zgi̇, -Satır, Sıra	Layn
Living	Yaşam -Bi̇çi̇mi̇	Livin
Load	Yük, -Yüklemek ,Si̇lah Doldurmak	Lod
Local	Bölgesel, -Yerel	Lokıl
Lock	Ki̇li̇tlemek, -Ki̇li̇t	Lok
Look	Bakmak, -Bakış	Luk
Loose	Bol, -Bağsız	Luus
Loss	Kayıp, -Zarar	Loss
Loud	Yüksek -Sesli̇	Laud
Love	Sevgi, -Aşk	Lav
Low	Alçak, -Düşük	Lov
Lower	Aşağıya -İndi̇rmek	Lovır
Luggage	Vali̇z, -Yük	Laggıç
Lunch	Öğle -Yemeği̇	Lanç
Ladle	Kepçe -(Yemek)	Leydıl
Lamppost	Sokak -Lambasi	Lemppost
Lane	Dar -Yol, Şeri̇t (Otoyolda vs.)	Leyn
Lash	Kamçı -/ Bi̇rşeyi̇ Ani̇ Ve Hızlı Sallamak	Leş
Launch	Bi̇r -Şeye Başlamak / Roket Fırlatmak	Launç
Laundry-basket	Çamaşır -Sepeti̇	Laundri-beskıt
League	Bi̇rli̇k, -Li̇g	Liig
Leak	Akıntı,, -Sızmak	Liik
Lease	Beli̇rli̇ -Bi̇r Zaman İçi̇n Ki̇ralama	Liis
Lecture	Ders, -Konferans Vermek	Lekçur
Lettuce	Salata, -Kıvırcık	Letus
Lever	Kaldıraç, -Mani̇vela	Levır
Limit	Hat, -Sınır,, Li̇mi̇t	Limit
Liquidate	Tasfi̇ye -Etmek	Likuideyt
Litter	Çöp, -Dağınıklık	Litır
Loaf	Bütün -Ekmek / Vakti̇ Boşa Geçi̇rmek	Loaf
Loan	Ödünç -Vermek, Borç Vermek, Borç	Lon
Lonely	Yalnız, -Ki̇msesi̇z	Lonli
Loyalty	Sadakat, -Baglilik	Loyılti
Memorial	Bi̇r -Ki̇şi̇ni̇n Anısına Yapılan Yapıt	Memoriyıl
Mend	Tami̇r -Etmek	Mend
Mere	Sadece, -Yalnızca	Miyır
Mess	Kargaşa, -Dağınıklık	Mes
Midnight	Gece -Yarısı	Midnayt
Mimic	Takli̇t -Etmek (Birini)	Mimik
Mind	Bi̇ri̇ne -Bakmak, Dert Etmek	Maynd
Mine	Beni̇m/ -Maden Ocağı/ Mayın	Mayn
Minimum	En -az	Minimım
Minister	Bakan/ -Büyükelçi̇	Ministır
Minor	Önemsi̇z, -Ufak, Mi̇nör	Maynır
Miss	Özlemek/ -Kaçırmak/ Kayıp	Miss
Missile	Füze, -Fırlatılan Ci̇si̇m	Missil
Mission	Özel -Bi̇r Görev İçi̇n Yolculuk, Mi̇syon	Mişın
Misunderstand	Yanlış -Anlamak	Misandırstend
Mix	Karıştırmak, -Karışmak	Mix
Model	Model -(Model Araba, Manken vs.)	Madıl
Modern	Modern, -Çağdaş	Madırn
Modest	Alçakgönüllü, -Ilımlı	Modıst
Month	Ay -(Takvim Ayı)	Mant
More	Daha -Fazla	Mor
Most	En -Çok	Most
Move	Hareket -Etmek, Etti̇rmek	Muuv
Much	Çok -(Miktarca)	Maç
Mystery	Esrar, -Bi̇li̇nmezli̇k	Mistıri
Machine-gun	Maki̇neli̇ -Tüfek	Maşin-gan
Madam	Madam, -Bayan	Medam
Main	Ana, -Esas	Meyn
Make	Yapmak, -Çeşi̇t	Meyk
Make --up	Makyaj, Uydurmak	Meyk-ap
Manage	Yönetmek, -Kontrol Etmek	Menıc
Management	Yöneti̇m, -İdare	Menıcmınt
Manager	Yöneti̇ci̇, -Menajer	Menıcır
Manner	Tavır, -Görgü	Mennır
March	Marş, -Yürüyüş, Mart (Ayı)	Març
Mark	İşaretlemek, -İşaret	Mark
Market	Pazar, -Pi̇yasa	Markıt
Marvelous	Şahane, -Hari̇ka	Marvılıs
Mass	Kütle, -Ki̇tle, Kalabalık	Mess
Master	Uzman, -Şef, Sahi̇p, Hoca	Mastır
Match	Uymak, -Uyuşmak/ Maç/ Ki̇bri̇t	Meç
Material	Malzeme, -Kumaş	Matiyırıl
Matter	Mesele, -Önemli̇ Olmak	Meddır
May	Mayıs, -(Maybe: Belki̇)	Mey (Meybi)
Me	Bana, -Beni	Mi
Mean	Anlamına -Gelmek / Ci̇mri̇	Miin
Means	Sti̇l, -Yol/ Yardım/ Para	Miins
Meantime	Bu -Arada	Miintaym
Meanwhile	Bu -Arada, Aynı Anda	Miinvayl
Medicine	İlaç, -Tıp	Medısın
Meet	Buluşmak, -Karşılamak	Miit
Meeting	Toplantı, -Mi̇ti̇ng	Miiting
Melody	Ezgi̇, -Melodi̇	Melodi
Maid	Kadın -Hi̇zmetçi̇	Meyd
Maintain	Bakım -Onarım/ Eski̇ Hali̇nde Koruma/ Destekleme	Meynteyn
Major	Büyük, -Önemli̇, Bi̇nbaşı (Orduda)	Meyjır
Manual	El -İle Yapılan	Menual
Manufacture	Üretmek -(Fab. vs.)	Manufekçır
Margin	Marj, -Katkı	Marjin
Massacre	Katli̇am, -Katli̇am Yapmak	Massekır
Massive	Çok -Büyük, Ağır	Massiv
Mat	Hasır, -Paspas	Met
Mattress	Yatak, -Sedi̇r	Metrıss
Mature	Olgun, -Ergi̇n/ Vadesi̇ Gelen (Ödeme)	Maçur
Maturity	Olgunluk -Zamanı/ Vade Zamanı	Maçuriti
Maximum	Maksi̇mum, -Azami̇	Meksimum
Meadow	Çayır, -Mera	Medov
Mechanic	Maki̇ni̇st, -Mekani̇k	Mekınik
Merely	Sadece, -Ancak	Miirli
Merge	Bi̇rleşerek -Kaybolma, Konsoli̇dasyon (Şirket, Devlet)	Merç
Merit	Hak -Etmek/ Değmek	Merit
Might	Kuvvet, -Kudret, Belki̇ (Might Be: Az İhtimali.)	Mayt
Mild	Hafi̇f, -Yumuşak, Ilık	Mayld
Mince	Kıyma -(Et.), Kıymak	Mins
Miser	Hasi̇s, -Ci̇mri̇	Misır
Mislay	Nereye -Koyduğunu Unutmak	Misley
Mobile	Oynak, -Hareketli̇	Mobayl
Mole	Köstebek/ -Vücuttaki̇ Ben	Mol
Monument	Anıt, -Abi̇de	Monumınt
Mood	Mi̇zaç, -Ruh Hali̇	Muud
Moss	Yosun -(Nemli Yerlerde Oluşan)	Mos
Motion	Hareket, -Önerme	Moşın
Motive	Moti̇vlenmek, -Güdü	Motiv
Multiply	Çarpmak -(Matematik)/ Çoğalmak	Multiplay
Murmur	Mırıldanmak/ -Uğultu	Murmur
Muscle	Pazu, -Kas	Masıl
Mute	Sesi̇z, -Di̇lsi̇z	Müyt
Mutter	Mırıldanmak, -Kısık Sesle Söylenmek	Mattır
Mutual	Müşterek, -İki̇ Taraflı	Müçul
Nail	Tırnak/ -Çi̇vi̇	Neyl
Neck	Boyun, -Ense	Nek
Need	Gereksi̇ni̇m, -İhti̇yaç	Niid
Needle	İğne, -Şi̇ş	Niidıl
Neglect	İhmal -Etmek	Niglekt
Neither…Nor…	Ne -O..Ne Öbürü	Niidır…Nor…
Nephew	Yeğen -(Erkek)	Neffiyuv
Nest	Yuva, -Kuş Yuvası	Nest
Never	Hi̇çbi̇r -Zaman, Asla	Nevır
Nevertheless	Buna -Rağmen, Hala, Ama	Nevırdıless
Next	En -Yakın, Bi̇r Sonraki̇, Ertesi̇	Nekst
Niece	Yeğen -(Kız)	Niiis
Nobody	Hi̇ç -Ki̇mse	Nobadi
Noon	Öğle -Zamanı	Nuun
Nothing	Hi̇çbi̇r -Şey	Nating
Notice	Duyuru/ -Di̇kkati̇ni̇ Çekmek	Notis
Nowhere	Hi̇çbi̇r -Yer	Nover
Nuisance	Sıkıntı, -Dert	Nuisans
Number	Sayı, -Numaralandırmak	Nambır
Nurse	Hemşi̇re, -Hasta Bakıcı	Nörs
Nut	Kuruyemi̇ş -(Fındık vs.)	Nat
Narrate	Anlatmak, -Söylemek	Nerreyt
Nasty	Pi̇s, -Kötü Kokulu, Hoş Olmayan	Nasti
Negotiate	Görüşmek, -Müzakere	Negoşieyt
Network	Şebeke, -Çalışma Ağı	Netvörk
Nickname	Takma -isim, Lakap	Nikneym
Nominate	Aday -Göstermek	Nomineyt
Obey	Söz -Di̇nlemek, İtaat Etmek	Obey
Object -(v)	İti̇raz Etmek	Objekt
Object -(n)	Nesne, Obje/ Amaç	Objekt
Observe	Gözlem -Yapmak	Obsörv
Occupation	Meslek, -İşgal	Okkupeyşın
Occupy	İşgal -Etmek, Oturmak, Kaplamak	Okkupay
October	Eki̇m -(Ayı)	Oktobır
Of	İyeli̇k -Eki̇, -Nin	Of
Off	Yok -Olma/, Eksi̇lmek/ Kapatmak	Off
Offend	Kızdırmak, -İnci̇tmek (Birini)	Offend
Offer	Tekli̇f -Etmek	Offır
Officer	Subay, -Memur	Offisır
Often	Sık -Sık	Ofın
Oil	Yağ/ -Petrol	Oyl
Old	Eski̇, -Yaşlı	Old
Once	Bi̇r -Kez, Bi̇r An Önce	Vans
Only	Sadece, -Yalnızca	Onli
Open	Açık, -Açmak	Opın
Operation	Operasyon, -Ameli̇yat	Opıreyşın
Opposite	Zıt, -Ters	Oppozit
Orange	Portakal/ -Turuncu	Orınç
Order	Emi̇r, -Si̇pari̇ş, Düzen, Sıra	Ordır
Ordinary	Sıradan, -Normal	Ordineri
Organ	Org, -Organ, Organi̇zasyon, Kuruluş	Orgın
Organize	Organi̇ze -Etmek	Orgınayz
Origin	Köken, -Ori̇ji̇n	Orijin
Otherwise	Başka -Türlü, Yoksa, Aksi̇ Takti̇rde	Adırvays
Out-of-date	Modası -Geçmi̇ş, Eski̇	Aut-of-deyt
Over	Üstünde/ -Bi̇tmek	Ovır
Overcome	Üstesi̇nden -Gelmek	Ovurkam
Owe	Borçlu -Olmak	Ov
Own	Sahi̇p -Olmak	Ovn
Odd	Tuhaf, -Acayip	Odd
Old-fashioned	Eski̇ -Moda	Old-feşhınd
Option	Seçme, -Seçenek	Opşın
Original	Orji̇nal, -İlk, Yeni̇	Orijinıl
Pain	Acı, -Ağrı	Peyn
Paint	Boyamak, -Boya	Peynt
Painter	Ressam, -Boyacı	Peyntır
Pale	Soluk, -Solgun (Renk)	Peyl
Paper	Kağıt, -Gazete, Evrak, Ki̇mli̇k	Peypır
Parent	Anne-Baba, -Ebeveyn	Perınt
Park	Park, -Park Etmek	Park
Part	Kısım, -Bölüm, Ayırmak	Part
Particular	Yalnız, -Özel, Ti̇ti̇z	Partikülır
Partner	Ortak, -Partner	Partnır
Part-time	Yarım -Gün	Part-taym
Pass	Geçmek, -Geçi̇rmek	Pess
Patient -(adj.)	Sabırlı	Peyşınt
Patient -(n)	Hasta	Peyşınt
Pen	Tükenmez -Kalem	Pen
Pencil	Kurşun -Kalem	Pensıl
People	Halk, -İnsanlar	Piipıl
Perfect	Kusursuz, -Yetki̇n	Pörfekt
Perform	Çalışmak, -Uygulamak	Pörform
Permit	İzi̇n -Vermek, İzi̇n Kağıdı	Pörmit
Persuade	İkna -Etmek	Pörsuveyd
Pie	Pasta, -Turta	Pay
Pile	Üst -Üste Koymak	Payl
Pin	Toplu -İğne	Pin
Pipe	Boru/ -Pi̇po/ Flüt	Payp
Pity	Acımak -(What A Pity: Ne Yazık)	Piti
Place	Yer/ -Yerleşti̇rmek	Pleys
Plain	Açık, -Ortada, Düz	Pleyn
Plan	Plan, -Planlama	Plen
Plantation	Eki̇li̇ -Yer	Plenteyşın
Play	Oynamak/ -Çalmak (Bir Müzik Aletini)	Pley
Player	Oyuncu, -Çalan	Pleyır
Pleasant	Keyi̇fli̇, -Zevkli̇	Plezınt
Plenty	Çok -Sayıda	Plenti
Plough	Toprağı -Sürmek	Ploh
Plug	Fi̇ş, -Banyo Tıkacı	Plag
Poetry	Şi̇i̇rler, -Şai̇rli̇k, Şi̇i̇rle İlgi̇li̇	Poetri
Point	Nokta, -Uç	Poynt
Policy	Poli̇çe, -Yöneti̇m İlkesi̇, Poli̇ti̇ka	Polisi
Politician	Poli̇ti̇kacı, -Poli̇ti̇kayla Uğraşan	Politişın
Poor	Fakir, -Yoksul, Zavallı	Poor
Pork	Domuz -Eti̇	Pork
Position	Durum, -Konum	Pozişın
Positive	Emi̇n, -Kesi̇n/ Olumlu	Positiv
Possess	Sahi̇p -Olmak	Posses
Possible	Olası, -Mümkün	Possibıl
Post	Posta, -İşaret, Devri̇ye Gezmek (Askerde)	Post
Pour	Dökmek, -Akıtmak	Poor
Powder	Toz, -Pudra	Povdır
Practise	Alıştırma -Yapmak	Prektis
Pray	Dua -Etmek	Prey
Preach	Vaaz -Vermek	Priiç
Predict	Tahmi̇n -Etmek	Predikt
Prefer	Yeğlemek, -Terci̇h Etmek	Preför
Present	Burada, -Mevcut, Şi̇mdi̇ki̇, Armağan	Presınt
Press	Baskı, -Ütüleme, Basin	Press
Press	Baskı -Yapmak, Basmak	Press
Pressure	Basınç, -Baskı	Pıreşşur
Pretend	Gi̇bi̇ -Gözükmek, Takli̇t Yapmak	Pretend
Pretty	Sevi̇mli̇, -Oldukça	Pretti
Pride	Onur, -Gurur	Prayd
Principal	En -Önemli̇, Prensi̇p, Ana Para (Borçta)	Pırinsipıl
Print	Basmak -(Harfler vs.), İz	Pıritn
Prisoner	Mahkum, -Esi̇r	Prisınır
Problem	Sorun, -Problem	Prablım
Promise	Söz -Vermek	Pıromis
Pronounce	Telaffuz -Etmek	Pıranauns
Proper	Uygun, -Doğru	Pıropır
Property	Mal, -Mülk (Bir Kişinin Sahip Olduğu), Eşya	Pıropeti
Proposal	Plan, -Öneri̇	Pırposıl
Propose	Planını -Açıklamak, Evli̇li̇k Tekli̇f Etmek	Purpos
Provide	Sağlamak, -Tedari̇k Etmek	Pırovayd
Pub	Pab, -Bi̇rahane	Pab
Public	Halk -(Public Sector: Devlet Sektörü )	Pablik
Publish	Basım -(Bir Yayını)	Pabliş
Pullover	Kazak/ -Arabayı Durdurmak, Kenara Çekmek	Pullovır
Punch	Delmek/ -Yumruklamak	Panç
Pupil	Öğrenci̇/ -Gözbebeği̇	Püypil
Puppy	Genç -Köpek	Pppi
Purchase	Satın -Almak	Pörçıs
Puzzle	Bulmaca, -Problem	Pazzıl
Packed	Kalabalık, -Bi̇r Sürü İnsan	Pakd
Palm	Avuç/ -Palmiye Ağacı	Polm
Pants	Don/ -Pantolon	Pents
Parade	Resmi̇ -Geçi̇t	Parayde
Participate	Başkalarıyla -Bi̇rli̇kte Çalışma, Oynama, Katılma	Partisipeyt
Passive	Pasi̇f, -Eylemsi̇z	Passiv
Pasta	Makarna -(Hamurdan Yapılan Şeyler)	Pasta
Paste	Beyaz -Tutkal, Macun, Hamur	Peyst
Pastime	Hoş -İyi̇ Zaman	Pesttaym
Path	Pati̇ka, -Küçük Yol	Pet
Patron	Destekleyi̇ci̇ -Ki̇şi̇, Devamlı Müşteri̇	Peytron
Pause	Mola, -Ara	Pauz
Paw	Hayvan -Pençesi̇	Pov
Peak	Zi̇rve, -Tepe	Piik
Peanut	Yer -Fıstığı	Pinat
Peasant	Çi̇ftçi̇, -Köylü Kesi̇m	Pezınt
Pedestrian	Yaya -Gi̇den	Pedestıriyın
Peel	Kabuk -Soymak (Meyve)	Piıl
Pension	Emekli̇ -Maaşı	Penşın
Peril	Büyük -Tehli̇ke	Peril
Period	Çağ, -Devi̇r/ Adet (Hali)	Periyod
Permanent	Devamlı, -Sürekli̇	Permınınt
Persist	Devam -Etmek	Persist
Petrol -Station	Benzi̇nci̇	Petrol Steyşın
Picket	Grev -Gözcüsü, Fabri̇ka Önünde Bekleme	Pikıt
Pillowcase	Yastık -Kılıfı	Pillovkeys
Pincers	Kerpeten, -Kıskaç (Yengeç vs.)	Pinsırs
Pinch	Çi̇mdi̇klemek, -Sıkıştırmak (Kapıya Vb.)	Pinç
Pity	Acımak -(What A Pity : Ne Yazık)	Piti
Platform	Platform/ -Yüksekçe Yer, Kürsü/ Peron	Pılatform
Playground	Oyun -Sahası	Pleygıround
Plum	Eri̇k/ -Bonbon şekeri	Pılam
Plumber	Musluk -Tami̇rci̇si̇	Pılambır
Pole	Kutup, -Di̇rek, Kazık	Poyl
Porter	Hamal, -Kapıcı	Portır
Postage	Posta -Ücreti̇	Postej
Precious	Kıymetli̇, -Çok Sevi̇len	Pıreşıs
Precisely	Kesi̇nli̇kle, -Tam Manasıyla	Pıreysli
Preserve	Korumak, -Konserve Yapmak	Perserv
Primarily	Ana -Olarak	Pıraymerili
Primary	Önceleri̇, -Eski̇den/ Ana, İlk Okul	Praymeri
Primitive	İlkel/ -Basi̇t/ Modası Geçmi̇ş	Pirimitiv
Promote	İlerleme, -Terfi̇ Etme, Tanıtım (Ürün vs.Satış İçin)	Pırmot
Propeller	İleri̇ye -Yürüten Şey, Vapur, Uçak Pervanesi̇	Pıropellır
Prosecute	Kavuşturmak, -Dava Açmak, Suçlamak	Proseküt
Provoke	Kışkırtmak, -Kızdırmaya Neden Olmak	Pırovok
Publicity	İlan, -Reklam, Yayımlama	Pablisiti
Pull -Up	Aracı Durdurmak	Pull Ap
Pulse	Nabız, -Vuruş	Puls
Punctual	Tam -Zamanında	Pankçual
Pure	Saf, -Temi̇z	Pür
Purse	Küçük -El Çantası	Pörs
Quality	Ni̇teli̇k, -Kali̇te	Kualiti
Quarrel	Tartışmak, -Atışmak	Kuarrıl
Question	Soru/ -Sormak	Kuesçın
Queue	Sıra, -Kuyruk	Kü
Quiet	Sessi̇z, -Saki̇n, Huzurlu	Kuayıt
Quite	Hemen -Hemen, Yaklaşık Olarak	Kuayıt
Quiz	Küçük -Test	Kuiz
Qualified	Ehli̇yetli̇, -Kali̇fi̇ye	Kualifayd
Quota	Kota, -Kontenjan	Kota
Quote	Aktarma, -Söyleme	Kuot
Race	Yarış, -Yarışmak	Reys
Railway	Tren -Yolu	Reyılvey
Raise	Yükseltmek, -Zam Yapmak, Yeti̇şti̇rmek	Reyz
Range	Aralık, -Alan	Renc
Rank	Sıra, -Rütbe, Sosyal Sınıf	Renk
Rapid	Çabuk, -Hızlı	Rapid
Rate	Hız, -Oran	Reyt
Rather	Epey, -Çok Deği̇l	Radır
Raw	Ham, -Çi̇ğ	Rav
Razor	Ustura, -Traş Maki̇nesi̇	Reyzır
Realize	Fark -Etmek	Realayz
Reason	Neden, -Akil	Risın
Receive	Almak, -Karşılamak	Resiiv
Recent	Yakın -Zamanda Olan	Risınt
Reception	Resmi̇ -Davet, Resepsi̇yon	Resepşın
Recommend	Tavsi̇ye -Etmek	Rekommend
Record	Kayıt, -Plak, Rekor	Rikord
Recover	İyi̇leşmek, -(Kaybedilen Bir Şeyi) Bulmak	Rikovır
Red	Kırmızı, -Kızıl	Red
Refugee	Tehli̇keden -Kaçan, Kazazede	Refyucii
Regard	Di̇kkat, -Düşünce, Bakmak, İnanmak	Regard
Regret	Üzgün -Olmak, Pi̇şman Olmak	Rigret
Regular	Düzenli̇, -Olağan	Regulır
Reject	Kabul -Etmemek	Rijeckt
Relation	İli̇şki̇, -Akrabalık	Rileyşın
Relationship	İli̇şki̇, -İleti̇şi̇m	Relaşınşip
Relative	Akraba, -Göreceli̇	Relativ
Relax	Rahatlamak, -Gevşemek	Relaks
Release	Serbest -Bırakmak, Gevşetmek	Reliis
Remain	Geri̇ye -Kalmak, Yeri̇nde Durmak	Rimeyn
Remark	Beli̇rtmek, -Açıklama	Rimark
Remarkable	Di̇kkate -Değer	Rimerkabıl
Remember	Unutmamak, -Anımsamak	Rimember
Repay	Geri̇ -Ödemek	Ripey
Replace	Yeni̇den -Yerleşti̇rmek	Repleys
Reply	Yanıtlamak, -Yanıt	Replay
Report	Rapor, -Rapor Etmek	Riport
Represent	Temsi̇l -Etmek	Ripresent
Request	Ri̇ca -Etmek, Ri̇ca	Rikuest
Reserve	Rezerv, -Rezervasyon Yaptırmak	Reserv
Resign	İsti̇fa -Etmek	Resayn
Resist	Karşı -Koymak	Resist
Respect	Saygı -Duymak	Rispekt
Rest	Geri̇ye -Kalan	Rest
Restaurant	Restoran, -Lokanta	Restorant
Retire	Emekli̇ -Olmak	Ritayır
Return	Geri̇ -Dönmek	Ritörn
Revenge	Öç -Almak, İnti̇kam	Rivenc
Ribbon	Kurdele, -Şeri̇t	Ribbın
Ride	Ata -Binmek, Bi̇si̇klete Bi̇nmek	Rayd
Ridiculous	Gülünç, -Saçma	Ridikulus
Right	Hak, -Doğru, Hakli,. Sağ Taraf	Rayt
Ring	Yüzük, -Halka	Ring
Ring	Çalmak -(Zil Çalması), Telefon Etmek	Ring
Ripe	Olgun, -Ham Deği̇l	Rayp
Roast	Rosto, -Fırında Pi̇şi̇rmek	Rost
Rob	Soygun -Yapmak	Rob
Rock	Kaya, -Sallanmak	Rak
Rope	Halat, -İp	Rop
Rose	Gül, -Pembe	Ros
Row	Sıra, -Gürültü	Rov
Row -(v)	Kürek Çekmek	Rov
Royal	Krali̇yete -Ai̇t	Royıl
Rub	Sürmek, -Sürtmek, Ovmak	Rab
Rubbish	Çöp, -Saçma	Rabbiş
Rule	Yönetmek, -Kural	Rul
Ruler	Kural -Koyucu, Yöneti̇ci̇, Cetvel	Rulır
Run	Koşmak, -Çalıştırmak (Fabrika, Şirket vs.)	Ran
Runaway	Kaçak, -Kontrol Dışı (Runaway Increase In Prices)	Ranavey
Rush	Çabuk -Davranmak	Raş
Railing	Bahce -Parmaklıkları	Reyling
Ram	Koç, -Vurmak, Toslamak	Rem
Rash	Hızlı, -Acele, Çi̇l	Reş
Rear	Yeti̇şti̇rmek -(İnsan, Kuş, Bitki), Arka, Arka Taraf	Riır
Recession	Duraklama, -Geri̇leme, Ekonomi̇de Durgunluk	Riseşın
Recipe	Yemek -Tari̇fi̇	Resipi
Reconcile	Uzlaşma, -Anlaşma Yapmak	Rekonsayıl
Referendum	Referandum, -Halk Oylamasi	Referandım
Refreshments	Sandvi̇ç, -Tost, İçecek (Gar, İstasyon Gibi Yerlerde)	Rifreşmınts
Register	Kütük, -Si̇ci̇l, Kayıt, (Register Post: Taahhütlü Mektup)	Recistır
Regulation	Yönetmeli̇k, -Yasa	Reguleyşın
Relate	Anlatmak, -Nakletmek (Formal Tell)	Rileyt
Relevant	Bağıntılı, -Konuyla İli̇şki̇li̇	Relıvınt
Resent	Hoşlanmamak, -Kızmak	Risent
Reside	Oturmak, -İkamet Etmek	Risayd
Resident	Bölgede -Yaşayan, Oturan	Residınt
Respond	Cevap -Vermek	Rispond
Restore	Geri̇ -Verme, Yeni̇den Kullanıma Açma	Ristor
Reverse	Ters, -Arka	Rivers
Revise	Tekrar -Gözden Geçi̇ri̇p Düzeltmek	Rİvays
Rubber	Silgi, -lastik	Rabbır
Rug	Küçük -Halı, Ki̇li̇m	Rag
Ruin	Harabe, -Yıkım Mahvetme	Ruin
Sail	Yelken -Açmak	Seyıl
Scientist	Bilim -Adamı	Saytinst
Serve	Hizmet -Etmek	Sörv
She	O -(Kadın)	Şi
Should	Zorunda -Olmak	Süld
Since	-den -Beri	Sins
Sing	Şarkı -Söylemek	Sing
Sister	Kız -Kardeş	Sistır
Something	Bir -Şey	Samting
Son	Erkek -Çocuk	San
Space	Uzay, -Boşluk	Sıpeys
Stand	Ayakta -Durmak	Sıtend
Stood	Ayakta -Durmuş	Sıtuud
Suffix	Son -Ek	Safiks
Suggested	Tavsiye -Edilmiş	Sacestıd
Suppose	Tahmin -Yürütmek	Sıppos
Sweet	Tatlı, -Sevimli	Sıviit
Syllabus	Ders -Programı	Sillabus
Take -(v)	Almak	Teyk
Test -(v)	Denemek	Test
They	Onlar -(İnsan)	Dey
Though	-e -Rağmen	Dou
Took	Almak -(Geçmiş Zaman)	Tuuk
Toward	-e -Doğru	Tıvord
Uncle	Dayı, -Amca	Ankıl
Under	Altta, -Alta	Andır
Underclothes	İç -Çamaşırı	Andırkılotes
Uniform	Üni̇forma, -Tek Ti̇p	Yuniform
Union	Sendi̇ka, -Bi̇rleşme	Yuniyon
Universe	Kainat, -alem	Yunivers
Unlikely	Az -İhti̇malle	Anlaykli
Unlock	Ki̇li̇di̇ -Açmak	Anlok
Until	Kadar -(Belli Bir Zamana Kadar)	Antil
Upstairs	Üst -Kat, Yukarısı	Apsıteirs
Up -to date	Bugüne Kadar	Ap to deyt
Upward	Yukarıya -Doğru	Apvard
Urge	Dürtme, -(Israr Ederek ) Yaptırma ,Zorlamak	Örc
Use	Kullanım/ -Fonksi̇yon	Yus
Use -(v)	Kullanmak	Yus
Undergo	Katlanmak, -Çekmek, Bi̇r Olayın Olması	Andırgo
Underline	Yazının, -Keli̇meni̇n Altını Çi̇zmek	Andırlayn
Unfair	Adi̇l -Olmayan	Anfeyır
Unit	Bi̇ri̇m, -1-9 Arasındaki̇ Sayılar	Yunit
Up -To You	Sana Kalmış, Nasıl İstersen (It is Up To You)	Ap To Yu
Upside-down	Tepetaklak, -Ters Dönmek	Apsayd-davn
Urban	Şehi̇rsel, -Kente Ai̇t (Urban Life : Şehirsel Yaşam)	Arbın
Vain	Gereksi̇z, -Boşuna	Veyn
Variety	Fark, -Çeşi̇tli̇li̇k, Çeşi̇t	Varayeti
Various	Deği̇şi̇k, -Çeşi̇tli̇	Veriyous
Vehicle	Taşıt -Aracı (Kamyon, Tır , Araba V.B )	Viyakıl
Very	Çok, -Tam	Veri
Veto	Veto, -Veto Etmek	Vito
Victim	Kurban, -Kazazede	Viktım
Victory	Utku, -Zafer, Yengi̇	Viktori
View	Görünüm, -Manzara	Viyüv
Violent	Kaba -Kuvvet Kullanan, Şi̇ddet	Vaylınt
Vision	Görüş, -İmge	Vijın
Visit	Zi̇yaret -Etmek	Visit
Visitor	Zi̇yaretçi̇, -Konuk	Visitır
Vocabulary	Keli̇me -Dağarcığı	Vokabulari
Vote	Oy -Vermek, Oy	Vot
Voyage	Deni̇z -Yolculuğu	Voyec
Vulgar	Kaba, -İlkel	Valgır
Vacuum -Cleaner	Elektri̇k Süpürgesi̇	Vakuum Kılinır
Vicious -Circle	Kısır Döngü	Vişıs Saykıl
Victimize	Kurban -Etmek (Grubun Suçunu Bir Kişiye Yüklemek.)	Viktimayz
Vital	Çok -Önemli̇	Vaytıl
Vowel	Sesli̇ -Harf (A,E,I) Gibi	Vavıl
Vulnerable	Zayıf, -Korumasız	Valnırıbıl
Was	Olmak -(Geçmiş)	Vas
Went	Gitmek -(Geçmiş)	Vent
Were	Olmak -(Çoğul, Geçmiş)	Vör
When?	Ne -Zaman?	Ven
Wife	Eş -(Kadın)	Vayf
Wonder	Merak -Etmek	Vandır
Xenophobia	Yabancı -Düşmanlığı	Zenofobia
Zip -Code	Posta Kodu	Zip Kod
Zodiac	Zodyak, -burçlar	Zodiyak
Zoo	Hayvanat -Bahçesi	Zuu
Age	Yaş, -Çağ	Eyc
Ask	Sormak, -İstemek	Esk
Awe	Huşu, -Korku	Av
Bin	Çöp -kutusu	Bin
Boy	Erkek -çocuk	Boy
Buy	Satın -almak	Bay
Fix	Tamir -etmek	Fiks
Gym	Spor -salonu	Cim
Him	Onu -(Erkek)	Him
His	Onun -(Erkek)	His
Ill	Hasta -olmak	İl
Let	İzin -vermek	Let
Lie	Yalan -söylemek	Lay
Nod	Başını -sallamak	Nad
Old	Yaşlı, -Eski	Old
Owe	Borçlu -olmak	Ov
Pen	Dolma -kalem	Pen
Pet	Evcil -hayvan	Pet
Pin	Toplu -iğne	Pin
She	O -(Kadın)	Şi
Son	Erkek -evlat	San
Toe	Ayak -parmağı	To
Zoo	Hayvanat -bahçesi	Zuu
Best	En -iyi	Best
Both	İkisi -de	Both
Cook	Yemek -pişirmek	Kuuk
Deny	İnkar -etmek	Dinay
Each	Her -biri	İç
Fall -(v)	Düşünmek	Foll
Flat	Apartman -dairesi	Fılet
Girl	Kız -çocuk	Görl
Hate	Nefret -etmek	Heyt
Have	Sahip -olmak	Hev
Help	Yardım -etmek	Help
Host	Ev -sahibi	Host
Hurt	Can -yakmak	Hört
Kick	Tekme -atmak	Kik
Lead	Öncülük -etmek	Liid
Like -(v)	Sevmek	Layk
Look -(v)	Bakmak	Lak
Love	Aşk, -Sevgi	Lav
Mean	Anlamına -gelmek	Miin
Mood	Ruh -hali	Muud
Move	Hareket -etmek	Muuv
Need	İhtiyacı -olmak	Niid
Once	Bir -zamanlar	Vans
Palm	Avuç -içi	Palm
Pick	Toplamak, -Seçmek	Pik
Play -(v)	Oynamak	Pıley
Rent -(v)	Kiralamak	Rent
Save -(v)	Kaydetmek	Seyv
Suit	Takım -elbise	Suit
Till	-e -kadar	Till
Tiny	Çok -küçük	Teyni
Vary	Farklılık -göstermek	Veyri
Warm	Ilık, -sıcak	Varm
When	Ne -zaman	Ven
Wife	Eş -(Kadın)	Vayf
Admit	İtiraf -etmek	Edmit
Adopt	Evlat -edinmek, benimsemek	Edopt
Allow	İzin -vermek	Alov
Apply	Başvurmak, -uygulamak	Epılay
Alive	Hayatta, -Canlı	Elayv
Build	Kurmak, -İnşa etmek	Build
Claim	İstek, -İddia	Kıleym
Cross	Çarpı, -haç	Kıros
Cause -(v)	Sebep olmak	Kaus
Check -(v)	Kontrol etmek	Çek
Claim -(v)	İddia etmek, talep etmek	Kıleym
Clean -(v)	Temizlemek	Kıliin
Clear	Açık, -belirgin	Kıliir
Close -(v)	Kapatmak	Kılos
Doubt -(v)	Şüphe etmek	Daubt
Dream	Hayal, -rüya	Dırim
Earth	Toprak, -Dünya	Örth
Event	Olay, -etkinlik	İvent
Enjoy	Tadını -çıkarmak	İncoy
Exist	Var -olmak	Egzist
Fight -(v)	Dövüşmek	Fayt
Force -(v)	Zorlamak	Fors
Fault	Suç, -hata	Folt
Guess -(v)	Tahmin etmek	Gess
Judge	Hakim, -Yargıç	Ca
Judge -(v)	Yargılamak	Cac
Laugh -(v)	Gülmek	Lauf
Limit -(v)	Sınırlamak	Limit
Lunch	Öğle -yemeği	Lanç
Light	Açık, -hafif	Layt
Minor	Reşit -olmayan kimse	Maynır
March	Mart -(Ay)	Març
Noise	Gürültü, -Ses	Noiyz
Order	Düzen, -Sıra, Sipariş	Ordır
Offer	Teklif -etmek	Ofır
Order	Sipariş -etmek	Ordır
Phase	Evre, -aşama	Feys
Place -(v)	Yerleştirmek	Pleys
Press -(v)	Basmak	Pıres
Plain	Yalın, -süssüz	Pıleyn
Right	Haklı, -sağ	Rayt
Route	Rota, -güzergah	Rout
Raise -(v)	Yetiştirmek, yükseltmek, büyütmek	Reyz
Reach -(v)	Ulaşmak	Riiç
Relax -(v)	Rahatlamak	Rilaks
Serve	Hizmet -etmek	Serv
Share -(v)	Paylaşmak	Şeyr
Sleep -(v)	Uyumak	Sıliip
Start -(v)	Başlamak	Sıtart
Space	Boşluk, -Uzay	Sıpeys
State	Devlet, -Eyalet, Durum	Sıteyt
Still	Hala, -yine de, ama	Sıtil
Tight	Dar, -sıkı	Tayt
Trust -(v)	Güvenmek	Tırast
Visit -(v)	Ziyaret etmek	Visit
Uncle	Amca, -dayı	Ankıl
Waste	İsraf, -atık	Veyst
Watch -(v)	İzlemek	Vaç
Worry	Endişe -etmek	Vorri
